#########################
#.......................#
#.#########...#########.#
#.#...................#.#
#......#.........#......#
#.#....#.........#....#.#
#.######.........######.#
#......#....SSSS.#......#
#.#...................#.#
#.......................#
#.......................#
#..........e............#
#.#...................#.#
#......#.........#......#
#.#....#.........#....#.#
#.######.........######.#
#......#.........#......#
#.#...................#.#
#.########....#########.#
#.......................#
#########################
