||||||||||||||||||||||||||||
|............||............|
|.||||.|||||.||.|||||.||||.|
|.||||.|||||.||.|||||.||||.|
|..........................|
|.||||.||.||||||||.||.||||.|
|......||....||....||......|
||||||.||||| || |||||.||||||
     |.||          ||.|     
     |.||  |    |  ||.|     
     |.    |MMMM|  ||.|     
     |.||  ||||||  ||.|     
     |.||          ||.|     
||||||.||  ||||||  ||.||||||
|............||............|
|.||||.|||||.||.|||||.||||.|
|...||.......P........||...|
|||.||.||.||||||||.||.||.|||
|......||....||....||......|
|.||||||||||.||.||||||||||.|
|..........................|
||||||||||||||||||||||||||||