#########################
#.......................#
#.#####################.#
#.#...................#.#
#......#.........#......#
#.#....#.........#....#.#
#.######.........######.#
#......#.........#......#
#.#...................#e#
#.#####################.#
#....................Se.#
#########################