|||||||||||||||||||||||||
|.......................|
|.|||||||||||||||||||||.|
|.|...................|.|
|......|.........|......|
|.|....|...MMM...|....|.|
|.||||||.........||||||.|
|......|.........|......|
|.|...................|.|
|.|||||||||||||||||||||.|
|...........P...........|
|||||||||||||||||||||||||